# https://en.wikipedia.org/wiki/List_of_ISO_3166_country_codes

China,_Taiwan_Province_of - TW
China,_Hong_Kong_SAR - HK
Republic_of_Korea - KR
Indonesia - ID
New_Zealand - NZ
Ireland - IE
South_Africa - ZA
Portugal - PT
Norway - NO
Malaysia - MY
Singapore - SG
India - IN
Australia - AU
Japan - JP
Thailand - TH
Russian_Federation - RU
Turkey - TR
Canada - CA
China,_mainland - CN
China - CN
United_States_of_America - US
Sweden - SE
Switzerland - CH
Denmark - DK
Greece - GR
Romania - RO
Hungary - HU
Czech_Republic - CZ
Austria - AT
Poland - PL
United_Kingdom - UK
Spain - ES
Italy - IT
Germany - DE
Netherlands - NL
Belgium - BE
France - FR